111111
11E111
111111
1P1C11
111111