111111
11X111
1XEX11
11X111
1P0C11
111111