1111111
1001001
101E101
100X001
1PXCX01
1111111