111111111111
100X00C00001
1XP0000C0001
1010011XC111
111001110111
100000000001
110111111111
10000000E101
111111111111
111111111111