11111111111111111111111111111
11100001111111110011100111111
11111111111111100001000011111
11CCCCCC111111110011100111111
111X1X01111111011111111101111
1111E001111111101111111011111
11P00111111111110000000111111
11111111111111111111111111111